#........#
#.........
#.........
#.........
#.........
#.........
#.........
#.........
#.........
##########