##########
..........
..........
..........
..........
..........
..........
..........
..........
#........#