#........#
..........
..........
..........
..........
..........
..........
..........
..........
##########