##########
.........#
.........#
.........#
.........#
.........#
.........#
.........#
.........#
#........#