#........#
.........#
.........#
.........#
.........#
.........#
.........#
.........#
.........#
##########